. . . . . . . . . . . . . . . . . . . . . . . . . . . .
. . . . . . . . . . . . . . . . . . . . . . . . . . . .
. . . . . . . . . . . . . . . . . . . . . . . . . . . .
1 1 1 1 1 1 1 7 8 1 1 1 1 1 1 1 1 1 1 7 8 1 1 1 1 1 1 1
. . . . . . . 3 3 . . . . . . . . . . 3 3 . . . . . . .
1 1 1 1 1 6 . 3 3 . 2 3 3 3 3 3 3 2 . 3 3 . 6 1 1 1 1 1
0 1 1 1 1 6 . 2 2 . 2 3 3 9 9 3 3 2 . 2 2 . 6 1 1 1 1 0
1 . . . . . . . . . . . . 3 3 . . . . . . . . . . . . 1
1 . 2 3 3 3 3 3 2 . 2 2 . 3 3 . 2 2 . 2 3 3 3 3 3 2 . 1
1 . 3 9 3 3 3 3 2 . 3 3 . 3 3 . 3 3 . 2 3 3 3 3 9 3 . 1
1 . 3 3 . . . . . . 3 3 . 2 2 . 3 3 . . . . . . 3 3 . 1
1 . 3 3 . 2 3 3 2 . 3 3 . . . . 3 3 . 2 3 3 2 . 3 3 . 1
1 . 2 2 . 2 3 9 3 . 3 9 3 3 3 3 9 3 . 3 9 3 2 . 2 2 . 1
1 . . . . . . 3 3 . 2 3 3 3 3 3 3 2 . 3 3 . . . . . . 1
0 1 1 1 1 6 . 3 3 . . . . . . . . . . 3 3 . 6 1 1 1 1 0
0 1 1 1 1 6 . 3 3 . 4 5 5 = = 5 5 4 . 3 3 . 6 1 1 1 1 0
1 . . . . . . 3 3 . 5 . . . . . . 5 . 3 3 . . . . . . 1
1 . 2 3 3 2 . 2 2 . 5 . . . . . . 5 . 2 2 . 2 3 3 2 . 1
1 . 2 3 9 3 . . . . 5 . . . . . . 5 . . . . 3 9 3 2 . 1
1 . . . 3 3 . 2 2 . 4 5 5 5 5 5 5 4 . 2 2 . 3 3 . . . 1
0 1 6 . 3 3 . 3 3 . . . . . . . . . . 3 3 . 3 3 . 6 1 0
. . 1 . 3 3 . 3 9 3 2 . 2 3 3 2 . 2 3 9 3 . 3 3 . 1 . .
. . 1 . 2 2 . 2 3 3 2 . 3 . . 3 . 2 3 3 2 . 2 2 . 1 . .
. . 1 . . . . . . . . . 3 . . 3 . . . . . . . . . 1 . .
. . 1 . 2 3 3 3 3 3 2 . 3 . . 3 . 2 3 3 3 3 3 2 . 1 . .
1 1 6 . 2 3 3 9 9 3 2 . 2 3 3 2 . 2 3 9 9 3 3 2 . 6 1 1
. . . . . . . 3 3 . . . . . . . . . . 3 3 . . . . . . .
1 1 6 . 2 2 . 3 3 . 2 3 3 3 3 3 3 2 . 3 3 . 2 2 . 6 1 1
0 1 6 . 3 3 . 2 2 . 2 3 3 9 9 3 3 2 . 2 2 . 3 3 . 6 1 0
1 . . . 3 3 . . . . . . . 3 3 . . . . . . . 3 3 . . . 1
1 . 2 3 9 3 . 2 3 3 3 2 . 3 3 . 2 3 3 3 2 . 3 9 3 2 . 1
1 . 2 3 3 2 . 2 3 3 3 2 . 2 2 . 2 3 3 3 2 . 2 3 3 2 . 1
1 . . . . . . . . . . . . . . . . . . . . . . . . . . 1
0 1 1 1 1 1 1 1 1 1 1 1 1 1 1 1 1 1 1 1 1 1 1 1 1 1 1 0
. . . . . . . . . . . . . . . . . . . . . . . . . . . .
. . . . . . . . . . . . . . . . . . . . . . . . . . . .
