. . . . . . . . . . . . . . . . . . . . . . . . . . . .
. . . . . . . . . . . . . . . . . . . . . . . . . . . .
. . . . . . . . . . . . . . . . . . . . . . . . . . . .
1 1 1 1 1 1 1 7 8 1 1 1 1 1 1 1 1 1 1 7 8 1 1 1 1 1 1 1
z - - - - - + 3 3 n p p p p p p p p n 3 3 + - - - - - z
1 1 1 1 1 6 | 3 3 p 2 3 3 3 3 3 3 2 p 3 3 | 6 1 1 1 1 1
0 1 1 1 1 6 | 2 2 p 2 3 3 9 9 3 3 2 p 2 2 | 6 1 1 1 1 0
1 N p p p p n p p n p p n 3 3 n p p n p p n p p p p N 1
1 p 2 3 3 3 3 3 2 p 2 2 p 3 3 p 2 2 p 2 3 3 3 3 3 2 p 1
1 p 3 9 3 3 3 3 2 p 3 3 p 3 3 p 3 3 p 2 3 3 3 3 9 3 p 1
1 p 3 3 n p p p p n 3 3 p 2 2 p 3 3 n p p p p n 3 3 p 1
1 p 3 3 p 2 3 3 2 | 3 3 n p p n 3 3 | 2 3 3 2 p 3 3 p 1
1 p 2 2 p 2 3 9 3 | 3 9 3 3 3 3 9 3 | 3 9 3 2 p 2 2 p 1
1 n p p n p n 3 3 | 2 3 3 3 3 3 3 2 | 3 3 n p n p p n 1
0 1 1 1 1 6 p 3 3 + - - - - - - - - H 3 3 p 6 1 1 1 1 0
0 1 1 1 1 6 p 3 3 | 4 5 5 . . 5 5 4 | 3 3 p 6 1 1 1 1 0
1 n p p p p n 3 3 | 5 . . . . . . 5 | 3 3 n p p p p n 1
1 p 2 3 3 2 p 2 2 | 5 . . . . . . 5 | 2 2 p 2 3 3 2 p 1
1 p 2 3 9 3 n - - + 5 . . . . . . 5 + - - n 3 9 3 2 p 1
1 n p n 3 3 p 2 2 | 4 5 5 5 5 5 5 4 | 2 2 p 3 3 n p n 1
0 1 6 p 3 3 p 3 3 + - + - - - - F - + 3 3 p 3 3 p 6 1 0
. . 1 p 3 3 p 3 9 3 2 | 2 3 3 2 | 2 3 9 3 p 3 3 p 1 . .
. . 1 p 2 2 p 2 3 3 2 | 3 . . 3 | 2 3 3 2 p 2 2 p 1 . .
. . 1 n p p n p p p p n 3 . . 3 n p p p p n p p n 1 . .
. . 1 p 2 3 3 3 3 3 2 p 3 . . 3 p 2 3 3 3 3 3 2 p 1 . .
1 1 6 p 2 3 3 9 9 3 2 p 2 3 3 2 p 2 3 9 9 3 3 2 p 6 1 1
y - - n p p n 3 3 n p n - - - - Y p n 3 3 n p p n - - y
1 1 6 p 2 2 p 3 3 p 2 3 3 3 3 3 3 2 p 3 3 p 2 2 p 6 1 1
0 1 6 p 3 3 p 2 2 p 2 3 3 9 9 3 3 2 p 2 2 p 3 3 p 6 1 0
1 N p n 3 3 n p p n p p n 3 3 n p p n p p n 3 3 n p N 1
1 p 2 3 9 3 p 2 3 3 3 2 p 3 3 p 2 3 3 3 2 p 3 9 3 2 p 1
1 p 2 3 3 2 p 2 3 3 3 2 p 2 2 p 2 3 3 3 2 p 2 3 3 2 p 1
1 n p p p p n p p p p p n p p n p p p p p n p p p p n 1
0 1 1 1 1 1 1 1 1 1 1 1 1 1 1 1 1 1 1 1 1 1 1 1 1 1 1 0
. . . . . . . . . . . . . . . . . . . . . . . . . . . .
. . . . . . . . . . . . . . . . . . . . . . . . . . . .
